Портирование билдовских локаций.

Задачи

KostaKrut : Кордон, свалка, янтарь, склады, бункер монолита, припять
Chaek08 : Росток, агропром, подземелья агропрома, x10,x16,x10, радар, чаэс 1 и 2

Дата старта : 15.10.2022
Дата окончания : ??.??.2022

Список уровней, их готовность :

Кордон                 
Свалка                           -
Агропром                         -
Подземелья агропрома             -
Бар                              -
Темная долина                    -
Лаборатория x18                  -
Дикая Территория                 -
Янтарь                           -
Лаборатория x16                  -
Армейские склады                 -
Радар                            -
Лаборатория x10                  -
Припять                          -
ЧАЭС                             -
ЧАЭС 2                           -
Саркофаг                         -
Бункер монолита                  -

